NO ./textures/fire.xpm
EA ./textures/wood2.xpm
WE ./textures/water.xpm
SO ./textures/galvanized_blue.xpm
C 10 , 10  , 10 
F 40 ,  40 ,  40 

1111111111111111
1111110000001111
1111100000000111
1111000011111111
1111000100000011
1111001000000001
111100E000000001
1001001000000001
1001000100000011
1000000011111111
1001000000000011
1001000000000011
1001000000000011
1001000000000011
1001000000000011
1001000000000011
1111000000000011
1111000111100011
1111000111100011
1111000111100011
1111111111111111
