NO ./textures/wood2.xpm
SO ./textures/wood2.xpm
WE ./textures/galvanized_blue.xpm
EA ./textures/galvanized_blue.xpm
F 255,100, 0
C 255,255,255

     1111111111111111111111111111
     1000000000110000000000001111
     1011000001110000000000001111
     100100000000000000000000
1
111111111011000001110000000001111
100000000011000001110111111111111
11110111111111011100000010001
111101111111110111010101110001111
110000001101010111000000100001111
10000000000000001100000N01001
10000000000000001101010010001
1100000111010101111101111000111
11110111 1110101 101111010001 
11111111 1111111 111111111111
