NO ./textures/wood2.xpm
SO ./textures/wood2.xpm
WE ./textures/galvanized_blue.xpm
EA ./textures/galvanized_blue.xpm
F 255,100,
C 255,255,255 

11111
10001
 10001
  10001
   10001
    1